1111111111111111111111111111111111111111
1000000000000000000000000000000000000001
1000010100111101000100010101000100000001
1000011000100001001010010101001010000001
1000010100100001110001010101001110000001
1000010100100001001010010101010001000001
1000010010111101000100011111010001000001
1000000000000000000000000000000000000001
1000000000000000000000000000000000000001
1000000111110000000111110000000000000001
1000011111111100011111111100000000000001
1000111111111110111111111110000000000001
1000111111111111111111111110000000000001
1000011111111111111111111100000000000001
1000001111111111111111111000000000000001
1000000011111111111111100000000000000001
1000000000011111111111000000000000000001
1000000000000111110000000000000000000001
1000000000000011100000000000000000000001
1000000000000001000000000000000000000001
1000000000000000000000000000000000000001
1001000101000101000101000101001000010001
1001000101101101000101001101001000010001
1000111101010101111101010101001000101001
1000000101000101000101010101001000111001
1000000101000101000101100101001001000101
1000111001000101000101000101111101000101
1000000000000000000000000000000100000001
1000000000000000000000000000000000000001
1000000000000000000000000000000000000001
1000000000000000000000000000000000000001
1000000000000000000000000000000000000001
1000000000000000000000000000000000000001
1000000000000000000000000000000000000001
1000000000000000000000000000000000000001
1000000000000000000000000000000000000001
1000000000000000000000000000000000000001
1000000000000000000000000000000000000001
1000000000000000000000000000000000000001
1111111111111111111111111111111111111111